1111111111
1000100011
1010C00101
1000000001
1010010101
10C0000001
1010101C11
1000000001
100P111101
1111111E11